WWWWWWWWWWWWWWWWWWWW
WP.................W
W.........WWWAAA...W
W....A.A..AAA..AA..W
W.A.....AAA..A..A..W
W.1......AA.AA..A..W
W...A.AAA..WWW.A...W
W..A......WWW.A....W
W..A.A.A..WWA.A....W
W..AA.A.A.WW.......W
WAA....A..WWW......W
WA..A.....WWA......W
W.......A.AWW.W....W
W.WWWWW....WWWWW...W
WWWWWWWWWWWWWWWWWWWW
